11111
1E0001
10C01
100P1
11110