111111111
100000001
10P000001
111111111
101C00111
1001000E1
111111111