111111111
1000001C1
10P000111
100000001
100000111
1000000E1
111111111