111111111
100000001
10P000001
100100001
101C10011
1001000E1
111111111