11111
11101
1E0001
10C01
100P1
11111