111111111
100000001
10P000001
100000001
100C00011
1000001E1
111111111