11111
1E001
10C01
10001
100P1
11111