1111111111111111111111111
1000011100000000001111111
10P0011100C00000000001111
1000000000000001100000001
100000C000000111111000001
11000000000111111E0000111
1000000000000111000000011
1011000000000000000000001
1C111000000000001100000C1
1111111111111111111111111