1111111
1C001E1
1010101
1P1C0C1
1010101
1111111
