1111111111111
10010000001C1
1000011110001
1P0111E000001
1111111111111