111111
1C11E1
101001
1P0C11
111111