11111111111111111111111
1111C000000000000000001
11111111100000000E00001
11111111000000000000001
10000110000000000000C01
100000000000C0000000001
1P000000000000000000001
11111111111111111111111