1111111111111111111111111
1000011100000000001111111
1C00011100C00000000001111
1110000000000001100000001
100P00C000000111111C00001
1111110000011111111111111
1111111000000000000000001
1111111100000000000110001
1111111111111011100110001
111E00000000001C0001C0001
1111111111111111111111111