111111111
100000001
10P000001
100100001
101C00011
10C1000E1
111111111